11111111111111111
10100000000000101
1110000C000010101
1C100P000E0010001
10100C00000C10001
10000000000010001
11111111111111111