1111111111111111111111111111111111
1P100010001000100010001000100010E1
1010101C10101010101C10101C10101C01
1C1010101010101C10101010101C1C1001
10101C10101C1010101C10101010101C01
100010001000100010C0100C10C0100001
1111111111111111111111111111111111