1111111111111111111111111111111111
1E001000C000010000C000001000000C01
1000100000000100000000001000000001
100010001000010001000C001000010001
100C00001000C000010000C01000010001
10P0000010000000010000000000010001
1111111111111111111111111111111111