1111111111111111111111111111111111
1E000C000000000000000000C000000001
1010010100100000101001000000010101
1010010010101010001001000C00010101
1P0000C0000000000000000000C0000001
100000000C000000000011000000000001
1111111111111111111111111111111111