1111111111111111111111111111111111
1E00100000000100000000001000000001
10001000P0000100000000001000000001
1000100010000100010000001000010001
1000000010000000010000C01000010001
1111111111111111111111111111111111