1111111111111
10010000000C1
100000E000011
1P00000000001
1111111111111