11111111111111111
1P100000000000001
1010000C000010001
1C1000000000100C1
10100C00E00C10001
10000000000010001
11111111111111111