11111111111111111111111
1P000100000000001000011
1000001000C000001000001
100C0001000000000E000C1
10000C0000C00C000000001
11111111111111111111111