11111111111111111111111
10000100000000001000011
1000001000C000001000001
111C00C10000000000000C1
1PE00C0000C00C000000001
11111111111111111111111