11111111111111111111111
1P000100000000001000011
1000001000C00E001000001
100C00010000000001000C1
10000C0000C00C000000001
11111111111111111111111